NO inc/HEARTSSV.xpm
EA inc/HOLYSV_1.xpm
SO inc/wallpaperSV.xpm
WE inc/lain.xpm

C 0,0, 144
F 255,255,255

1111111111111111
 10000000000001
  100000000001
   1000000001
    1000N001
   1000000001
  100000000001
 10000000000001
1111111111111111