NO inc/west.xpm
EA inc/south.xpm
SO inc/east.xpm
WE inc/HOLYSV_1.xpm

C 0,0, 144
F 255,255,255

111111111      1111111111
100W000011111110000000001
1000000000000000000000001
1000000000000000000000001
1111111111110111111111111
1111111111100011111111111
1111111111111111111111111