NO inc/krobus.xpm
EA inc/skeletons.xpm
SO inc/bats.xpm
WE inc/goomba.xpm

C 135,206,235
F 15,6,40

111111111111111
111111000111111
111110000011111
1111000N0001111
111000000000111
110000000000011
100001111100001
110000111000011
111000010000111 111
111100000001111 101
111110000011111 111
111111000111111
111111111111111